abgesehen - apart from
abschleulich - disgusting
absehen - to predict
abstimmen - to vote
abwehren - to repulse
allerlei - all sorts
altertümlich - ancient
am Zug sein - it's one's turn
anschnallen - to strap on
anstoßen - to clink glasses
auffielen - to stand out
aufhören - to stop, to end
aufkrempeln - to roll up
aufschiessen - to leap
ausklinken - to release
auszuhalten - to endure
auszuknipsen - to switch off
ạbsehen - to leave aside, to ignore
bangen - to be anxious
baumeln - to dangle
befürchten - to fear
begaffen - to stare
begreifen - to understand
behaupten - to assert
beiläufig - casual
besa̲u̲fen - get drunk
beschimpfen - to swear
besinnen - to reflect
besonnt - sunlit
bestehen - to exist
bestreiten - to contenst, to deny
betreffend - concerning
betteln - to beg
beweisen - to prove
beziehungsweise - respectively, or
bloß - bare, only
brüllen - shout, roar
das Achselzucken - shrug
das Dickicht – thicket
das Eingeweide - insides, entrails
das Erwachen - awakening
das Fahrgestell - chassis
das Farnkraut - fern
das Gefieder - plumage
das Geklimper - plunking
das Gerücht - rumor
das Gespenst - ghost
das Gewehr - rifle
das Gewimmel - teeming mass
das Gewimmel - throng, mass
das Gewirr - babble of voices
das Gewitter - storm
das Hitze - heat
das Händeschütteln - handshake
das Jenseits - beyond
das Rudel - horde
das scheppern
das Schneetreiben - blowing snow
das Sieb - strainer
das Staatsgebiet - national territory
das Staunen - astonishment
das Tal - valley
das Tau - rope
das Totenreich - kindgom of the dead
das Trittbrett - running board
das Zeitvertreib - pastime
das Zeug - stuff
der Aasgeier - vulture
der After - anus
der Aufenthalt - stay
der Ausfall - failure, cancellation
der Ausspruch - remark
der Bub - boy, lad
der Donner - thunder
der Dunst - haze
der Durchschlag - carbon copy
der Ehebruch - adultry
der Ekel - revulsion, disgust
der Entschluss - decision
der Esel - donkey; ass, idiot
der Hafen - port, dock
der Hang - tendency
der Hanswurst - clown
der Hohn - scorn, derison
der Hummer - lobster
der Irrsinn - madness
der Kahn - barge, rowing boat
der Kamin - fireplace
der Keim - shoot, seed, germ
der Kiesel - pebble
der Koller - rage
der Krach - row
der Kran - crane
der Kranke - patient
der Laie - the laymen
der Landwirt - famer
der Leib - body, stomach
der Molch - newt
der Molche - newt
der Pneu - tyre
der Rohling – brute
der Rückzug - retreat
der Schalter - counter
der Schatten - shadow
der Schaum - froth, foam
der Scheinwerfer - spotlight
der Schimmer - shimmer
der Schlepper - tractor, tug
der Schopf - crest
der Schädel - skull
der Sockel - base
der Stoß - punch, kick, blow
der Strohhut - straw hut
der Sturz - fall, accident
der Sumpf - marsh
der Sumpf - swamp, marsh
der Säugling - infant
der Tümpel - pond
der Umstand - fact, detail
der Umweg - detour
der Verschleiß - wear, consumption
der Verwaltungsrat - board of directors
der Vortrag - lecture
der Vorwurf - reproach
der Wedel - palm
der Wirt - landlord
der Zopilot - black vulture
der Zufall - chance, coincidence
der Ärmel - sleeve
die Abreise - departure
die Achsel - shoulder, armpit
die Anschaulichkeit - clarity
die Anweisung - instruction
die Ausrede - excuse
die Auswanderung - emigration
die Behauptung - assertion
die Blässe - paleness
die Brunst - rut, heat
die Bude - hut
die Bö - gust, squall
die Bügelfalten - crease
die Dienstreise - business trip
die Distel - thistle
die Eidechse - lizard
die Einsilbigkeit - to reizen
die Empörung - outrage
die Faust - fist
die Finsternis - darkness
die Flechten - lichen
die Fährte - trail
die Fügung - providence
die Geste - gesture
die Glut - ember, ash, heat
die Herkunft - origin
die Hetze - rush
die Hupe - horn
die Hüfte - hip
die Knarre - rattle
die Kunstfee - fairy
die Lawine - avalanche
die Masern - measles
die Muscheln - mussel
die Mühe - trouble
die Offenbarung - epiphany
die Pfeife - pipe
die Pfütze - puddle
die Revolte - revolt
die Rille - groove
die Schauergeschichte - horror story
die Schläfe - temple
die Schwärmerin - dreamer
die Sinflut - flood
die Spur - trace, track
die Stille – quiet
die Stimmung - mood
die Tinte - ink
die Tracht - traditional costume
die Tragfläche - wing
die Trümmer - rubble
die Tätigkeit - job
die Unkenntlichkeit - unrecognizable state
die Vernunft - reason
die Verwesung - decomposition
die Wahrsagerei - fortune telling
die Watte - cotton wool
die Weile - while
die Wolldecke - blanket
die Wut - fury
die Zustellung - delivery, submission
dreckig - filthy
drehen - to turn
drollig - funny, comical
dunstig - hazy
durchblicken - to hint
eben - flat, even, just, precisely
ebenfalls - likewise
eilen - to hurry
ein Affenschwein haben - to have luck
einerlei - all the same
einheimisch - native
einig - agreed
eintreten - to enter
ekeln - be disgusted
empfangen - to receive
entschließen - to make up one's mind
entschlossen - determined
entzückend - delightful
erbrechen - to vomit
erklärlich - understandable
erledigen - to deal with, to resolve
erraten - to guess
errechenbar - calculable
errechnen - to calculate
erschrecken - to be startled
erschöpft - exhausted
erwischen - to catch
erwähnen - to mention
erzeugen - to produce
falten - to fold
famos - splendid
fassen - to grab
fassen - to grasp
faul - lazy
ferner - furthermore
fetzen - to tear
flimmern - to flicker
flitzen - to shoot, to dart
flott - smart, quick, lively
flüstern - to whisper
foppen - to pull one
fụ̈rchten - to be afraid of
gelegentlich - occassional
gemäß - according to
geradezu - almost, direct, blunt
geradezu - downright
Geratewohl - without direction, randomly
geschwätzig - talktative
gewissenhaft - conscientious
gleichviel - no matter
glitschig - slippery
greifbar - within reach
gähnen - to yawn
günsting - favorable
hallen - to echo
hocken - to crouch
huschen - to slip, to to dart
irgend - any
irgendein - some
kaum - barely
keinesweg - by no means
kippen - to tilt, to tip
klagen - to complain
klebrig - sticky
klopfen - to knock
kreidebleich - pale as chalk
krempeln - to roll
krumm - to bend
kühn - bold, brave
laut + Gen/Dat - according to
lauwarm - lukewarm
lediglich - only, merely
moderig - musty
moosig - mossy
mühsam - laborious, forced
neuerdings - recently
nichtsdestoweniger - nonetheless
obschon - although
offenbar - obvious
opfern - to sacrifice
pfeifen - to whistle
plumpsen - splash
rasch - quick, rapid
rauschen – drunkeness
reglos - motionless
reiben - to rub
rieseln - to trickle
ringsum - all around
rostig - rusty
rutschen - to slide, to slip
sachliche - objective
sacken - to plummet
satt - full, fed up with
sausen - to whistle
scheiden - to divorce
scheppern - to clank
scheußlich - dreadful, awful
schieben - to push
schleimig - slimy
schlottern - to shiver, to shiver
schlüpfrig - slippery
schmierig - greasy
schnurgerade - dead straight
schonen - to spare, to protect
schräg - slanted, tilted
schwatzen - to chat
schwindlig - dizzy
schwitzen - to sweat
sehnen - to long for
senkrecht - vertical
sich begnügen - to content oneself
soeben - just
soeben - just now
sogar - even
sogleich - immediately
solch - such
sonderbar - strange, odd
sondergleichen - unparalleled
sonst - otherwise
sowenig - as little
sprühen - to spray
spöttisch - mocking
spüren - to feel
spüren - to sense, to feel
stapfen - trump
starr - stiff
stauen - to marvel
staunen - to be amazed
steil - steep
stoßen - kick, punch
streicheln - to stroke
stumm - wordless, silent
summen - to hum
topfeben - flat as a pan
trillern - to warble
trösten - to comfort
trübe - murky
tuten - to toot
umgekehrt - vice versa
unerschụ̈tterlich - unshakeable
unfähig - incapable
unhöflich - impolite
unumgạ̈nglich - necessary
unvermeidlich - unavoidable
verdrecken - filthy, dirty
vergeblich - futile
vergnügt - happy, cheerful
verheul - swollen from crying
vermutlich - probable
vernommen - to question, to examine
vernünftig - sensible
verrutschen - to slip
versagen - to fail
verschlammt - muddy
verschoben - to postpone
versehentlich - inadvertent
versprechen - to promise
verstecken - to hide
verstummen - to go silent
vertragen - to tolerate
vertragen - tolerate
verweigern - to refuse
verwesen - to decompose
volkommen - perfect, complete
vollkommen - perfect, complete
vollkommen - perfectly
voran - ahead
vorder - front
vorläufig - temporary
vorweisen - to produce
wackeln - wobble
wagen - to risk
weigern - to refuse
widerlich - repulsive
wieso - why
wimmeln - to swarm
winken - to wave
wippen - to bob up and down
wütend - angry
zahllose - countless
zerknittern - to crease, to crumble
zerlegen - to dismantle
zerren - to drag
zischeln - to hiss, to whistle angirly
zucken - to twitch
zucken - to twitch, to jerk
zufällig - by chance
zwingen - to force
zünden - to ignite
äußerst - extremely
überholen - to overtake
überwinden - overcome
üblich - usual
übrig - remaining
übrigens - by the way