die Gelbsuch – jaundice
der Blumenstrauß - bouquet of flowers
der Straßenrand - roadside
der Leib - body
der Widerwillen - reluctance
wuchtig - massive
sich übergeben - to vomit
das Erbrochene - vomit
schlucken - to swallow
würgen - to choke
schleim - mucus
grob - rough, coarse
hohl - empty, hollow
der Span - chip, splint
kreischen - to screetch
der Eimer - bucket
aufhören - to stop
der Schweiß - sweat
verwundert - amazed
die Entschlossenheit - determination
verabschiden - to say goodbye
das Geschoss - floor, storey
der Verleih - rental
verzichten - to do without
schmal - narrow
die Fassung - frame; composure
die Säule - column
eisern - iron
die Zeile - line, row
vorstellen - to introduce; to imagine
der Läufer - carpet; runner
verwirren - to confuse
taub - deaf
stumm - mute
bucklig - hunchback
hinkend - limping
der Rauch - smoke
beruhigen - to calm down
umkehren - to turn back
die Klinke - handle
stets - always
hügelig - hilly
die Gegend - area
düster - dark, gloomy
staubig - dusty
der Reifen - tyre
unschlüssig - indecisive
der Läufer - carpet
auffallen - to notice
falten - to fold
blass - pale
die Spange - clasp
bücken - bend down
rekonstruieren - reconstruct
der Backenknochen - cheeckbone
herb - sharp, bitter
vorbeugen - to bend
der Po - bottom
der Spalt - crack, opening
raffen - to ruffle
der Flur - hallway
verbergen - to hide, to conceal
die Lehne - back of a chair
der Kittel - overall, coat
absetzten - to put down